,#第一关1234567897878878778***
{0,0,0,0,0,0,0,0,0,0},
{0,0,0,1,1,1,0,0,0,0},
{0,0,0,1,2,1,0,0,0,0},
{0,0,0,1,0,1,1,1,1,0},
{0,1,1,1,3,3,0,2,1,0},
{0,1,2,3,6,0,1,1,1,0},
{0,1,1,1,1,3,1,0,0,0},
{0,0,0,0,1,2,1,0,0,0},
{0,0,0,0,1,1,1,0,0,0},
{0,0,0,0,0,0,0,0,0,0}
,#第二关
{0,0,0,0,0,0,0,0,0,0},
{0,0,1,1,0,0,1,1,0,0},
{0,1,0,0,1,1,0,0,1,0},
{1,0,2,3,0,0,3,2,0,1},
{1,0,0,0,6,0,0,0,0,1},
{0,1,0,0,3,0,0,0,1,0},
{0,0,1,0,0,3,0,1,0,0},
{0,0,0,1,2,2,1,0,0,0},
{0,0,0,0,1,1,0,0,0,0},
{0,0,0,0,0,0,0,0,0,0}
,#第三关
{0,0,0,0,0,0,0,0,0,0},
{0,1,1,1,1,1,1,1,1,0},
{0,1,0,0,2,0,0,0,1,0},
{0,1,0,0,0,0,0,0,1,0},
{0,1,0,0,3,3,0,2,1,0},
{0,1,2,3,6,0,0,0,1,0},
{0,1,0,0,0,3,0,0,1,0},
{0,1,0,0,0,2,0,0,1,0},
{0,1,1,1,1,1,1,1,1,0},
{0,0,0,0,0,0,0,0,0,0}
,#第四关
{ 1,1,1,1,1,1,1,1,1,1 },
{ 1,1,0,0,0,0,0,0,0,1 },
{ 1,1,0,1,1,1,1,0,1,1 },
{ 1,1,3,0,0,0,0,0,0,1 },
{ 1,0,3,3,0,0,0,0,0,1 },
{ 1,2,2,3,0,0,1,0,0,1 },
{ 1,2,2,0,0,0,1,6,0,1 },
{ 1,0,0,1,1,1,1,0,0,1 },
{ 1,0,0,0,0,0,0,0,0,1 },
{ 1,1,1,1,1,1,1,1,1,1 }